┌───────────┬───┬───┐
│           │   │   │
│ ╶───┬─╴ ┌─┴─╴ │ ╷ │
│     │   │     │ │ │
├─┬─╴ │ ╶─┤ ┌───┘ │ │
│ │   │   │ │     │ │
│ │ ╶─┴─┐ │ └───╴ │ │
│ │     │ │       │ │
│ └───╴ │ └───┬───┤ │
│       │     │   │ │
│ ╶───┬─┴─╴ ╷ ╵ ┌─┘ │
│     │     │   │   │
│ ┌───┤ ┌─┬─┴─┐ │ ┌─┤
│ │   │ │ │   │ │ │ │
├─┘ ╷ │ │ ╵ ╷ ╵ │ │ │
│   │ │ │   │   │ │ │
│ ╶─┤ ╵ ├───┤ ╶─┤ │ │
│   │   │   │   │ │ │
│ ╷ └───┘ ╷ └───┘ ╵ │
│ │       │         │
└─┴───────┴─────────┘
