#######################
#######################
##           #   #   ##
## ####### ##### # # ##
##     #   #     # # ##
###### # ### ##### # ##
## #   #   # #     # ##
## # ##### # ##### # ##
## #     # #       # ##
## ##### # ######### ##
##       #     #   # ##
## ######### # # ### ##
##     #     #   #   ##
## ##### ####### # ####
## #   # # #   # # # ##
#### # # # # # # # # ##
##   # # #   #   # # ##
## ### # ##### ### # ##
##   #   #   #   # # ##
## # ##### # ##### # ##
## #       #         ##
#######################
#######################
