tests/tmp/6_check_maze_solving_unicode_output.txt
┌───────────┬───┬───┐
│O████████  │   │   │
│ ╶───┬─╴█┌─┴─╴ │ ╷ │
│     │███│     │ │ │
├─┬─╴ │█╶─┤ ┌───┘ │ │
│ │   │███│ │     │ │
│ │ ╶─┴─┐█│ └───╴ │ │
│ │     │█│       │ │
│ └───╴ │█└───┬───┤ │
│       │X    │   │ │
│ ╶───┬─┴─╴ ╷ ╵ ┌─┘ │
│     │     │   │   │
│ ┌───┤ ┌─┬─┴─┐ │ ┌─┤
│ │   │ │ │   │ │ │ │
├─┘ ╷ │ │ ╵ ╷ ╵ │ │ │
│   │ │ │   │   │ │ │
│ ╶─┤ ╵ ├───┤ ╶─┤ │ │
│   │   │   │   │ │ │
│ ╷ └───┘ ╷ └───┘ ╵ │
│ │       │         │
└─┴───────┴─────────┘
===EOF===
